1111111111
1010000001
1010101011
1010101001
1011101011
1000000001
1011011011
1011011001
1000000011
1111111111
